16x16
#S##############
#.#............#
#...####.#######
#.#.#..........#
#.#.#.######.#.#
#.###.#....###.#
#.....#..#.#...#
####.###.#.#.#.#
#....#...#...#.#
#.######.#######
#......#.......#
####.#.#.#####.#
#..#.#...#...#.#
#.##.#####.#.#.#
#..........#.#.E
################
