14x13
#...###..##..
..#..###..#.E
..S.#.#.#.#..
#..###....#.#
.#...#####...
....#.#.#...#
###.#.###..##
#...#..#.#..#
..#.##.####.#
...#...#.##..
..#.##.####.#
#..##..#....#
.#.........#.
####.###.#..#
