14x14
S#E##...###...
.#....#.....#.
.###.###.####.
...#.#.#......
##.###.####.##
.....#......#.
##.#####.##.#.
...#...#....#.
.###.######...
...#.....#..#.
.#.#.#.#.##.#.
.......#....#.
##.#.#.###.##.
...#...#......
